CART.status  CART.remarks  
abfugtri	ncvthcpfjwdijnggijhcadrhzbgelplaajrbui	
aneqkfxl	mbbkfxrwafhmyxehngsbzziqmtjnctbabpfxyn	
apaiijxa	aejhpvmzfjpkbablmizckknggblxpxmqvihyvx	
beaoekiw	bitujiaexgjwibmfpjqcuwudoimygugywguoyq	
bfbwbpwb	myzqfkpdxkewucmwjiqejzyghpuujvdyuyqtvi	
bftbedcb	vqrhghxpetdzuopwxoxgvrpuaqydzyndlsuavt	
bqdxgyas	bbnyjptqqpuikfhqxnblngpslljasmrvfjhxnz	
cavqetie	nqtvkkwhcrwqhexbzkyexncosgbiclndxuljgs	
cfmugqwr	rqrcnpsvxmjlqhgwfokfvqaamtjaktndajjaap	
cfzbrrkm	akblegutwisweifrchrnqaulayqndgpyfgtulu	
csknuydr	rxrpbbczjgitkwyjqvkcgaawwagceryfrclerr	
cuolbsou	ohcfbwlgftcbtenagkqygbocttszystanqqfku	
dcingkeg	sjdmbortwxededhhqbrjdjgonjvywpsomrenpp	
dcpsnghc	ddjvktywpqnpflbausatrnivvodcemwqqdiosa	
deowynrp	ystdcemhpgkuyocxbtxpdaejpzabetmbmqbqzh	
dfsotjof	nycpbfvauvzbyckwxczlhurfqfqisitapyjykp	
dtgafkeh	tigtnzezacljrdnhmibvuqhrdyeumgudsxralk	
elyfwzbl	zdbapvvphfsrmyeoozmwmfesbpbogrlgcjewcd	
elyilduc	aaxwqvrbkewfmalhzubsaoqdyjkxpzszizqwty	
etfgkfuv	sggvwgiqxorcjxlzdaxupkzpjycvcajacrdqyv	
frufkpfg	ozayqvmiojqleejavnmmhhpfcjbgwflhpqufeq	
gkjjuxad	xsqwadovkaqmgojxwcibqhtotwvedoudsgbajb	
glqzbufq	adjvwfowshprljzrgtxxcsbuoghizouokeyehx	
gmvconyt	mntwibopythqwhwvsskzbgpdtkqpafjxoestzc	
gpflxikb	nhhkwfwjjezstrnjbjcehaixqxvxblnwutrhyd	
haienxtv	apmzgnxjgqqwofofzrubcewlimdokaswkjeaja	
hbhetsqj	pguqarsnaqjqrldoismhzfnfnmpqhozaprdoch	
heyxcfkd	lxsviuunvmpngjvwodxheattcvmszduniruhpl	
hxqglcsk	rbguahegbqzlnipvtacjmsuylkmsjtlwfaoupl	
iabihmyc	vydecrmvotmtqgyjoxlzjjhmsbjsamoswsrcjm	
ikekbkfw	wjwzucdrjkhgbqurujoqvnozltwtrdecmwwcll	
jdbojljc	rdujwxwkhumrhcwxgbyewxcfazzpjibddqxqjh	
jjnhoemv	jyhvjnewgwwrititpbabssdfuoykhkcrlfiaxl	
jvmjsyqg	xrbzwdlirozrbuyrrfcvslwbpvoyxqbycgynlg	
jxeuabzg	kogiiyuxvmeurvyhgjqwmwiwprhuwecmrlglvp	
jxxuccne	ixmuuwgpbxkfayshcntvyecfhlfflcjcuiqscp	
kcwvrqaa	vokuxhpdmiwkfxolumslvhgpawszcdzptgerdq	
kdvihczn	hojtembkajvqzqumezzefqdvufcpwyswadjonc	
keoebzwq	yrkgawvcbigjqbskhwwriskviagffqdahooxjj	
koxdncti	yyoyatjjatdkdhhpgymvtbuincryxsvypntdbu	
ljvmaeth	yucyptiqnnxmrextusgavevklxvextvczphzvx	
lpdzkdss	mprptfpsduyydudoruggclsklhxsronycnsfcn	
lthfqfcf	irtmweoeatmwhafycrpmtafcwwnyqesrxokdbg	
mfdogegv	icbdllotilokncxhumdphewigdgaqwjcqwsajb	
mginchkh	tadolfofeewamhkzeubqgqoxrhiehyrjofcvqr	
mgkwqdhl	yelzgxxwyjhqfhcnzyzmclqqxtuegymwjiscxt	
mijkymgs	obbawowlsxmojvwrjexevznvxycjeiuegcxgee	
mlichnqg	rmxwqbxxyzoodmluimxubfdwlasdabbrblnomi	
msaewfym	aqkyghtplgqpncxbszbyjpijkyujjhjplmwyji	
mvoflanv	jycckjtzeixdgzoacnpbhmxkniyqcyanzzfahc	
nfbwnwhz	nzsmicjzjoiofadrszaleoavkbxmggucfwsmdb	
nokghhag	qypnqfbapkthyoikzggkfkiorwcubfndbhotlg	
nsypcpbo	yuglojtflqztugpbyrboapyrtccbjopcodtyan	
oarabwyf	mfppforiktpcitbbgmsvglryrawwkfmcyrwjzq	
owecesbm	bqggbzkqziouhqsphliyodhrjwxhoplbzubsma	
ozqickke	njdcehuggvigslijtlzejgpnlhyfylloylkwck	
pbvzwgfh	uaqcxdvferhstfvqxubdkhxodqhhexanrximzi	
pbzmfmcs	kfmqagtrwrnzltiwxofqadldyfpvpxshowpiob	
petytpit	iaapfvjurlzczcvgfmsuronypuwwfvvmygmzhs	
pkyfygae	kpvepioskbqzvtbrsdcmhvoirdlbojrcrqddzd	
polzdizc	uoycmakmetgnfbyghqojapfuuueihehwyftqxb	
ppxsqxtt	xgyjzyypmtzczukghdfbtczkujzcabxcjdnjkm	
pwrxvlpa	cyuckogjzmqhsohtcaosorjdkdmkgkzgubvmbs	
qfswvijy	mdhskmgxbidscazwyvkkiygwmulplruncavfua	
qmuyevzc	fwmooshqtzfzmkuafefgsnblhihvwcwurrxrae	
qntafaep	xxgiroolefyormbjodhdmmomdiqyhrbkpcipht	
rhxmitzp	kiobpwqeiairhwxvjlebzuzvixbjfejowayjem	
rmzzmaju	kxwlifuycyglmfrvwtxboiscwjdsecdtpacqhi	
rphglaok	csryznwriggilobtizwuxetmjlgksilmzoqnyg	
rvyfckfm	dkdovsxwqnfvyqjtlxhggvhwfeuqedrpwotkgi	
slmulvxf	lejqgfpmfpnaynfrdvycrditfyslgupchlsfks	
suirzbtu	cbflycgtogptthvxxzsgwjgqvmjisetpidmtqa	
tchxduyl	zuivbojfowsyokpjaygbvorhpslsflzytksiyn	
tebltnmc	wmiqoqjmpqmlsxpntwfskrufbvxnwaemcyelsr	
twpyuzbq	vclsmguopbiqymmpxvpgjvevlkwhqzqkavddqq	
twwxzcls	owgiagrdemkccbfdeoyzfgavkzjpcdsbjbvele	
tzghfzkx	ehgkwpawlmgxqfuaycdyhnayzptjmhivrlwpik	
ueocweed	xzmntkgfzlhwmcptnxapkidxwweglucsqzusls	
ugfspnhr	xbskdynzlxoivnmtfonafbuiqthhnbkgetewzm	
uqmmsnrb	krhwwhzcexthgfinvfyjhrqcfijufsyutvjceh	
uuygnkux	dweeqqwbbiastwepdqikqaceigsijkctpohxhh	
uvkervkj	dnulbemltbswnczktyipurckzlxuxxecmbqfeg	
uxlwwksn	ziausnccsfoqcignynopmcvqnzahhabgygmyjq	
vbawjmec	nhfyiwerpeythexdqicjbcjykixgtsimosuwrd	
vhiravxw	vvfjoiyrspapheutlheonxxqyoktvpdnyudscs	
vuucszjc	mrervdwfmhmmhmlgcgletgjwmdiblgmrqyflls	
wbzxjpix	grcspfamgspahqgpmeqkuaimjdoprvcoruwboo	
wpqyjyno	vmwipyvlekaruudezbqtcamwvoogcxsrnfnhov	
wptxwlaz	tbwosglqbwocgdsufgcnppfxvnqtvmclhmbnnl	
wszaijpr	yckesqvuyadpdirkvvtldzdcbytnbazsgekinp	
xfssbjqw	duibzsqhqlupwluorruqkmunclquxorethutfy	
xlgrqmzh	dbsbhkuypvaxunkxcqbcmpfeeqzbgtiuieplhe	
xlrililr	digssbrqyqzhvijfcfemoamgnvfjdnrqtbhsha	
xycawsbf	eluhvwpjerbhmiyubwvipxvcvrqhigtbjndyyj	
yrpkxcra	awvneedvhjngwgkbtkzoidjoszklphlklsbcma	
ytmmxhlh	oyyqcnuesikawicwllachzoyetnkzpgdfcxhvp	
yvvyddsw	jqnptfxfnqzzspazhhyxlzeygzgwuagwpbkshv	
ywxexupx	gaqisrloofosblwyuxyzejuvgizgyobmjiqfgb	
zknpxeau	psjjwjllnqfecesmvlqxxmltvcmjgkbiwxrshp	
zwpahyin	klizwvpcwburfrsibesogaylprqmleqtfrvchj	
